NO ./textures/no.xpm
SO ./textures/so.xpm
WE ./textures/we.xpm
EA ./textures/ea.xpm

F 420,100,0
C 225,30,0

11111
12S01
10N01
10E01
111W1
