NO ./textures/no.xpm
554122
SO ./textures/so.xpm
sdjjdssdajsda
EA ./textures/ea.xpm

11111111111111111

F 220    ,100,0
C 225,30,0






10000000000000001
10000000000000001
10000010000000001
10010000000000001
10000W00000000001
10001010000000001
10001000100100001
10000000000000001
11111111111111111