
NO ./textures/no.xpm
SO ./textures/so.xpm
WE ./textures/we.xpm
EA ./textures/ea.xpm


F 100,50,0

C 225,30,0

11111111111111111
10000000000000001
10000000000000001
10000000000000001
10000000000000001
1000000E000000001
10000000000000001
10000000000000001
11111111111111111
