   NO    ./textures/no.xpm
SO ./textures/so.xpm
WE    ./textures/we.xpm
EA ./textures/ea.xpm

F   0,  0,255
C 255,255,255

1111111
1000001
10S0001
1000001
1111111