NO ./textures/no.xpm
SO ./textures/so.xpm
WE ./textures/we.xpm
EA ./textures/ea.xpm

F 220,100,0
C 225,30,0

11111111111111111
10000000000000001
10000000000010001
10001000000000001
1000000000000N001
10001000000000001
10000000000000001
10000000000101011
10000000000000001
11111111111111111
