NO ./textures/no.xpm
SO ./textures/so.xpm
WE ./textures/we.xpm
EA ./textures/ea.xpm

F 220,100,0
C 225,30,0

11111111111111111
10000000000000001
10000000000000001
10000010000000001
1001000000000N001
10000000000000001
10001010000000001
10001000100100001
10000000000000001
11111111111111111
