NO ./textures/text1.xpm
SO ./textures/text4.xpm
WE ./textures/text2.xpm
EA ./textures/text3.xpm


C 255,255,0
F 0,102,51
11111111111111111
10000000000000001
10000000000010001
10001000000000001
1000000000000N001
10001000000000001
10111000111000001
101 10001 1101011
101 10001 1000001
111 11111 1111111
