NO ./textures/no.xpm
SO ./textures/so.xpm
WE ./textures/we.xpm
EA ./textures/ea.xpm

F 220,100,0
C 225,30,0

11111
10001
10N01
10000
11111
